30 center 12 0 44 34
99 99 99 99 99 99 99 99 99 99 99 99 30 99 99 99 99 99 99 99 99 99
99 99 99 99 99 99 99 99 99 99 99 99 01 99 99 99 99 99 99 99 99 99
99 01 01 01 01 01 01 01 01 01 01 01 01 01 01 01 01 01 01 01 01 99
99 01 01 01 01 01 01 01 01 01 01 01 01 01 01 01 01 01 01 01 01 99
99 01 01 01 01 01 01 01 01 01 01 01 01 01 01 01 01 01 01 01 01 99
99 01 01 01 01 01 01 01 01 01 01 01 01 01 01 01 01 01 01 01 01 99
99 01 01 01 01 01 01 01 01 01 01 01 01 01 01 01 01 01 01 01 01 99
99 01 01 01 01 01 01 01 01 01 01 01 01 01 01 01 01 01 01 01 01 99
99 01 01 01 01 01 01 01 01 01 01 01 01 01 01 01 01 01 01 01 01 99
99 01 01 01 01 01 01 01 01 01 01 01 01 01 01 01 01 01 01 01 01 99
99 01 01 01 01 01 01 01 01 01 01 01 01 01 01 01 01 01 01 01 01 99
99 01 01 01 01 01 01 01 01 01 01 01 01 01 01 01 01 01 01 01 01 99
99 01 01 01 01 01 01 01 01 01 01 01 01 01 01 01 01 01 01 01 01 99
99 01 01 01 01 01 01 01 01 01 01 01 01 01 01 01 01 01 01 01 01 99
99 99 99 99 99 99 99 99 99 99 99 99 99 99 99 99 99 99 99 99 99 99
99 99 99 99 99 99 99 99 99 99 99 99 99 99 99 99 99 99 99 99 99 99